5 7
0 0 0 0 1 1 1
1 1 0 0 0 0 1
1 0 1 0 1 0 0
1 0 0 0 1 0 1
1 1 1 0 0 0 1
V
V
V
J
J
J
Z
Z
S
@